@@@@@@@@@@@@@@@@@@@@@@..@@@@@@@@@@@@@@@@@@@@
@@@@@@@@@@@@@@@.........@@....@@@@@@@@@@@@@@
@@@@@@@@@@@@...@@@@..@@@..@@@@...@@@@@@@@@@@
@@@@@@@@@@...@@@@@@@@@@@@@@@@@@@@..@@@@@@@@@
@@@@@@@@@..@@@@@@@@@...@.@@@@@@@@@@..@@@@@@@
@@@@@@@@..@@@@@@.............@@@@@@@.@@@@@@@
@@@@@@@@@.@@@@.@...............@@@@@.@@@@@@@
@@@@@@@@.@@@@@..................@@@@@.@@@@@@
@@@@@@@@.@@@@@.................@@@@@@.@@@@@@
@@@@@@@@.@@@@@..................@@@@@.@@@@@@
@@@@@@@@.@@@@.@@@@.@...@........@@@@..@@@@@@
@@@@@@@@.@@@@..@@..@.....@......@@@@@.@@@@@@
@@@@@@@@.@@@@.@@@@@@@@..@@@@@@@.@@@@..@@@@@@
@@@@@@@@..@@@.@@.@@.@@@.@@@@.@@.@@@@..@@@@@@
@@@@@@@@.@@@@.@@.@@@@@@@....@@..@@@@@.@@@@@@
@@@@@@@@.@@@@.@....@@@@@.........@@@@.@@@@@@
@@@@@@@@.@@@@......................@@.@@@@@@
@@@@@@@@.@@@@.@@.................@@@...@@@@@
@@@@@@@@.@@@@.@.@.@@............@@@@@.@@@@@@
.@@@@@@@@@@@@@@@@@@@@@@@@@@@@@@@@@@@@.@@@@@@
.@@@@@@@@@@@@@@@@@@@@@@@.@..@@@@@.@@@.@@@@..
@@@@.@@@@@@@................................
@@@@@@@@@@@@@@@.............................
@@@@@@@@@@@@@@@..............@....@@@@@@@@..
